1111111111
1C00000001
1000P0BBB1
100000BE01
1111111111
