1111111111111
100100B000001
1000000000001
10C0011111001
1P0011E000C01
1111111111111
